hg18	Human	RefSeq Genes, Ensembl Genes, Genscan Genes, UCSC Known Genes, RepeatMasker
mm9	Mouse	RefSeq Genes, Ensembl Genes, Genscan Genes, UCSC Known Genes, RepeatMasker
galGal3	Chicken	RefSeq Genes, Ensembl Genes, Genscan Genes, RepeatMasker
xenTro2	Frog	RefSeq Genes, Ensembl Genes, Genscan Genes, RepeatMasker
danRer4	Zebrafish (Zv6)	Ensembl Genes, Genscan Genes, Zebrafish mRNAs, Human UCSC Known Genes (peptides), RepeatMasker
danRer5	Zebrafish (Zv7)	RefSeq Genes, Ensembl Genes, Zebrafish mRNAs, Human UCSC Known Genes (peptides), RepeatMasker
fr2	Fugu	Ensembl Genes, Fugu mRNAs, RepeatMasker
tetNig1	Tetraodon	GAZE Genes, Genscan Genes, Tetraodon mRNAs, RepeatMasker
gasAcu1	Stickleback	Ensembl Genes, Stickleback mRNAs, RepeatMasker
oryLat1	Medaka	Ensembl Genes, Medaka mRNAs, RepeatMasker
dr3	Drosophila melanogaster	RefSeq Genes, FlyBase Genes
monDom4	Opossum	ensGene,refGene,genscan,all_mrna
ornAna1 Platypus	ensGene,refGene,all_mrna,repeatMasker
ce4	C_elegans	sangerGene,refGene,repeatMasker
caePb1 C_brenneri	all_mrna,repeatMasker
caeRem2	C_remanei	all_mrna,repeatMasker
canFam2	genscan,refGene,all_mrna, RepeatMasker
cb3	C_briggase	all_mrna,repeatMasker
priPac1	Pristionchus_pacificus	all_mrna,repeatMasker
ci2	Ciona	jgiExons,refGene,xenoRefGene,all_mrna,repeatMasker
dm3 Drosophila	FlyBase 5.2 and refGene; entire chrUextra masked
dp4	-
droAna3 -
droMoj3 -
droVir3 -
GmGo
